000000000000000000
001111110111111100
012220000000033310
012220000000033310
012220000000033310
010000000000000010
010000000000000010
010000000000000010
000000000000000000
010000000000000010
010000000000000010
010000000000000010
010000000000000010
013330000000022210
013330000000022210
013330000000022210
001111110111111100
000000000000000000