000000000000000000
001010101010101000
011020302030200010
011020302030200010
011020302030200010
011010101010101010
011111111111111110
000000000000010010
022200000000000000
000000000000003330
033311000000000010
000000001000113330
011011101001110010
010302020203020010
010302020202020010
010302020303020010
001111110111111100
000000000000000000