000000000000000000
001010101010101000
011020302030200010
011020302030200010
011020302030200010
011010101010101010
011111111111111110
000000000000000000
022200000000000000
000000000000003330
033300000000000010
000001000000103330
000001001000010010
010302020203020010
010302020202020010
010302020303020010
000000000000000000
000000000000000000