000000000000000000
001111111111111100
012200033330002210
012000000000000210
010000000000000010
010011100001110010
010010000000010010
013010001000010310
013010010100010310
013010001000010310
013010000000010310
010010000000010010
010011100001110010
010000000000000010
012000000000000210
012200033330002210
001111111111111100
000000000000000000