000000000000000000
001111110111111100
012221000000133310
012221000000133310
012221000000133310
010000000001110010
010000001010000010
010000001010000010
000000000000000000
010000010100000010
010001100011100010
010000000000000010
010000000000000010
013330000000022210
013330000000022210
013330000000022210
001111110111111100
000000000000000000